00100000000000000000100000000000
00100000000000000000100000000000
00111111111100111100111100111100
00000000000100000100100000100100
00000000000100000100100000100100
11111111100100100100100111100100
00000100000100100100100100000000
00000100000100100100100100000000
00111100111111100100100100111111
00000000100000100100000100000000
00000000100000100100000100000000
00111111100100100111111111111100
00100000000100000100000100000000
00100000000100000100000100000000
00111100111111111100100100111111
00100000100000000000100100000100
00100000100000000000100100000100
00100111111111111111100111100100
00100000100000000000100000100100
00100000100000000000100000100100
00111100100111111100111100100100
00000100100000100100000000100100
00000100100000100100000000100100
11100100111100100111111100100100
00100100000100100000000000100000
00100100000100100000000000100000
00100100100100111111111111111100
00100100100100100000000000100000
00100100100100100000000000100000
00100111100100100111111100100111
00000000000100000000000100000000
00000000000100000000000100000000
